#######################
#          P          #
# ### ### ### ### ### #
# ###      #      ### #
# ### ### # ### ### ### 
#     # # # #     #   #
# ### # # # # ### ### #
# #                 # #
# # ### ##### ### ### #
#                     #
# ### ### ### ### ### #
#       ###           #
# ### ### ### ### ### #
# ### #     # ### #   #
# ### # ### # ### # ###
#     # ### #         #
# ##### ### ##### ##### 
#                     #
#######################