################################
#                              #
#                              #
#                              #
#                              #
#              P               #
#                              #
#                              #
#                              #
#                              #
#                              #
#                     F        #
#                              #
#                              #
################################