################################
#                              #
#                        F     #
#                              #
#                              #
#              P               #
#                              #
#                              #
#                              #
#                              #
################################